XXXXXXXXXXXXXXXXXX
X.l..##....dd.m..X
X...m##>...##..m.X
Xtb.m##t..l##...>X
X.<..dd....ddm.t.X
########d#d#######
########d#d#######
X...>##....##....X
X....dd....ddt.<.X
X...mdd.p.m##....X
X....##.m..##....X
####d#########d###
####d#########d###
X....##..m.##...lX
Xmmb.dd<m..dd...mX
X....##..m.##....X
X.t..##m...##...mX
XXXXXXXXXXXXXXXXXX
